000000000000000000000000000000000
011111111111111111000011111111110
012111111111111121000012111111210
011111111111111111000011111111110
011100000000000111000011100001110
011100000000000111000011100001110
011100000000000111000011100001110
011100000000000111000011100001110
011100001111111111111111111111110
011100001211111111111111111111210
011100001111111111111111111111110
011100001111111111111111100000000
011100001111111111111111100000000
011100001111111111111111100000000
011100001111111111111111100000000
011111111111111111111111111111110
012111111111111121111111111111210
011111111111111111111111111111110
000000001111111111111111100001110
000000001111111111111111100001110
000000001111111111111111100001110
000000001111111111111111100001110
011111111111111111111111100001110
012111111111111111111112100001110
011111111111111111111111100001110
011100001110000111000000000001110
011100001110000111000000000001110
011100001110000111000000000001110
011100001110000111000000000001110
011111111110000111111111111111110
012111111210000121111111111111210
011111111110000111111111111111110
000000000000000000000000000000000

